




      NO ./textures/lava.png
      EA ./textures/wall3.png
      SO ./textures/wall.png
      WE ./textures/blue_wall.png

     F    8, 54, 6
     C    101, 133, 161


111111111111111111111111
100000000000000000000001
100000000000000000000001
100000000000000000000001
100000000000000000000001
100000000000000000000001
100000000000000000000001
100000000000000000000001
100000000000000000000001
10000000000N000000000001
100000000000000000000001
100000000000000000000001
100000000000000000000001
100000000000000000000001
100000000000000000000001
100000000000000000000001
100000000000000000000001
100000000000000000000001
111111111111111111111111